11111111111111111111
11111111111111111111
21111111111111111111
22222222222222222222
22222222222222222222
22222222222222222222
22222222222222222222
22222222222222222222
22222222222222222222
22222222222222222222
22222222222222222222
22222222222222222222
