33333333333333333333
33311222222222211333
33311222233222211333
33311222233222211333
33311222333322211333
33311222333322211333
33111222333322211133
33111222333322211133
33311222233222211333
22222222233222222222
22222222222222222222
33331111222211113333
