33333333333333333333
31111112222221111113
31111112222221111113
31222222222222222213
31211112211221111213
31213312133121331213
31213312133121331213
31211112211121111213
31222222222222222213
31111112222221111113
31111112222221111113
33333333333333333330
