33333333333333333333
31111111111111111113
31133311333311333113
31113111111111131113
31113111133111131113
31113111333311131113
31113111333311131113
31113111133111131113
31133311111111333113
31111111111111111113
31113331111113331113
33333333333333333333