33333333333333333333
31111111113111111113
31111111131111111113
31111111111111111113
31333311333311311133
31311311311111311313
31311311311111313113
31311311333311331113
31333311111311313113
31311111111311311313
31311111333311311133
33333333333333333333
